Libri emtores ιο professi nunt aflne mensis Novembris 186⁷,
usquead mensem majam 10⁵9.

mv e tp ο u: me Bnehhandlung von Μαι Komieker.
kyburg: Dio M. Rieger'ncho Buohhudlung.
Bnel: Die Buchhandlung von J. G. Neukireh.
„ Schweighauner'sche Buchhandlung.¹
Berlin: Dio Buchhandlung von Δ. Asher ἁ 0⁰· GExompl.
„ Vosn'sche Sortiments-Buchhandlung.
nun: Die Buchhandlung von Huber lt 0⁰·
Βιιμ u z: Die Buchhandlung vo‘n J. N. Teutsch.
Rumon: Dle Buchhsndluug von J. G. Heyse.
Brenln: Dio Buchhandlnng von F. Hirt.
. ., „ ⁴ „ Mu a 0⁰·
Βιοιιιὶι ug: Dio Mittlor'sohe Buehhandlung.
m ι ι el: Dio Buehhmdiung von Kieuling ἁ 0⁰·
„ Buehliudlwg von G. Muquardt.
Biekebur'g: Hert θοὴ. Leg.-Rath V. von stram.
θιιὶιιιι h e: Dio Bnun'ueho Hofbuehhandlung.
., Geuner'seho Buehhandlnng.
cnon: Die Buehhnndlung von D. Ε. Friedloin.
Dtuzig: Dio Buehhandlung von F. Δ. Weber.
Dumndt: Die Hosbuehhandlung von G. Jonghaus.
1) orptt: Die Buchhandlung von E. F. Karou.
Elberfol d: Ηοιι Βίιιοιοι Βι, Ph. Wackernagel ῆι die Renhehulo.
rnnkfurt ι. ιιι Die Bibliothek de· Gymnasium.
„ stmtbibnomek durch die Buehhandlung vnn Tb. Vbloker.
Der Phytioalische veroin durch die Smerlflnder'ncho Buehhandlung.
Fr eibum: Die Wagner'sehe Buehhandlung 2 Exempl.
Gens: Hert Prof. E. Plantamour durch die Buehhandlung von Katamana.
Graan: Die Ηοιιοίοῑιο Buohhandlung noch 1 Exomle
Gr δ ιι i ιι g ο n: Dio Academischo Bibliothek durch Th. Thomu in Leipzig.
fl ιιιι b ιι rg: Die Buchhnndlung von Nontler ἁ Melle.
‚. Διωι libmy in New-York d ὼ ΜΝ. Bm ἁ um
Ηιιι Dr. Med. Heilbntt m ⁹ ’
Η ι ιι ι u: Du Gymnasium durch Herm Diroctor Piderit.
ε Dio universim-Bibliothek durch dle Emmerlinfl'oohe Buchhtndlung.
ε nio &abhandlung ιοιι Wuenim ὁ 0⁰·
τ Die Wagner'nehe Buuhhmdlung.

 

